################
#..............#
#..............#
#..111111111...#
#..............#
#....1111......#
#..............#
#....11...1....#
#..............#
#..............#
#..............#
#..............#
#..............#
#..............#
#..............#
#..............#